A&S - ARTS & SCIENCES
AAS - ASIAN AMERICAN STUDIES
AEM - APPLIED ECONOMICS & MANAGEMENT
AEP - APPLIED & ENGINEERING PHYSICS
AGSCI - AGRICULTURE & LIFE SCIENCES
AIRS - AIR SCIENCE
AIS - AMERICAN INDIAN STUDIES
ALS - AGRICULTURE & LIFE SCIENCES
AMST - AMERICAN STUDIES
ANSC - ANIMAL SCIENCE
ANTHR - ANTHROPOLOGY
ARCH - ARCHITECTURE
ARKEO - ARCHEOLOGY
ART - ART
ARTH - HISTORY OF ART
ASIAN - ASIAN STUDIES
ASRC - AFRICANA STUDIES & RESEARCH CENTER
ASTRO - ASTRONOMY
BCS - BOSNIAN, CROATIAN, SERBIAN
BEE - BIOLOGICAL & ENVIRONMENTAL ENG
BENGL - BENGALI
BIOAP - BIO -- ANIMAL PHYSIOLOGY & ANATOMY
BIOBM - BIO -- BIOCHEMISTRY MOLECULAR & CELL
BIOEE - ECOLOGY & EVOLUTIONARY BIOLOGY
BIOG - BIOLOGY -- GENERAL
BIOGD - BIO -- GENETICS & DEVELOPMENT
BIOMG - MOLECULAR BIOLOGY GENETICS
BIOMI - MICROBIOLOGY
BIOMS - BIO MEDICAL SCIENCE
BIONB - BIOLOGY -- NEUROBIOLOGY & BEHAVIOR
BIOPL - PLANT BIOLOGY
BIOSM - SHOALS MARINE
BME - BIOMEDICAL ENGINEERING
BSOC - BIOLOGY & SOCIETY
BTRY - STATS & BIOMETRY
BURM - BURMESE
CAPS - CHINA ASIAN PACIFIC STUDIES
CATAL - CATALLAN
CAU - CORNELL ADULT UNIVERSITY
CEE - CIVIL & ENVIRONMENTAL ENGIN
CHEM - CHEMISTRY
CHEME - CHEMICAL ENGINEERING
CHIN - CHINESE
CHLIT - CHINESE LITERATURE
CIS - COMPUTER & INFORMATION SCIENCE
CLASS - CLASSICS
COGST - COGNITIVE STUDIES
COLLS - COLLEGE SCHOLAR PROGRAM
COML - COMPARATIVE LITERATURE
COMM - COMMUNICATION
COMS - COMPUTER SCIENCE
COSEP - COSEP
CRP - CITY & REGIONAL PLANNING
CS - COMPUTER SCIENCE
CSS - CROP & SOIL SCIENCES
DANCE - DANCE
DANSH - DANISH
DEA - DESIGN & ENVIRONMENTAL ANALY
DSOC - DEVELOPMENT SOCIOLOGY
DUTCH - DUTCH
EAS - EARTH & ATMOSPHERIC SCIENCES
ECE - ELECTRICAL & COMPUTER ENGINEER
ECON - ECONOMICS
EDUC - EDUCATION
ENGL - ENGLISH
ENGLB - ENGLISH FOR LATER BILINGUALS
ENGLF - ENGLISH AS A FOREIGN LANGUAGE
ENGRC - ENGINEERING COMMUNICATIONS
ENGRD - ENGINEERING DISTRIBUTION
ENGRG - ENGINEERING GENERAL INTEREST
ENGRI - INTRO TO ENGINEERING
ENINT - ENGLISH FOR INTERNATIONAL STUDENTS
ENTOM - ENTOMOLOGY
FDSC - FOOD SCIENCE
FGSS - FEMINIST, GENDER & SEXUALITY
FIELD - FIELD WORK
FILM - FILM STUDIES
FRDR - FREEHAND DRAWING
FREN - FRENCH
FRLIT - FRENCH LITERATURE
FRROM - FRENCH LANGUAGE - ROMANCE
FSAD - FIBER SCIENCE AND APPAREL DESIGN
GERLA - GERMAN LANGUAGE
GERST - GERMAN STUDIES
GOVT - GOVERNMENT
GREEK - GREEK
HADM - HOTEL ADMINISTRATION
HD - HUMAN DEVELOPMENT STUDIES
HE - HUMAN ECOLOGY (NON-DEPARTMENTAL)
HINDI - HINDI
HIST - HISTORY
HORT - HORTICULTURAL SCIENCES
HUNGR - HUNGARIAN
IARD - INTL AG & RURAL DEVELOPMENT
IEP - INTENSIVE ENGLISH PROGRAM
ILRCB - COLLECTIVE BARGAINING
ILRHR - ILR HUMAN RESOURCE MANAGEMENT
ILRIC - INTERNAT & COMPAR LABOR RELAT
ILRID - INDUS LABOR REL INTERDEPARTMENTAL
ILRLE - LABOR ECONOMICS
ILRLR - ILR LABOR RELATIONS, LAW, HISTORY
ILROB - ORGANIZATIONAL BEHAVIOR
ILRST - ECONOMIC & SOCIAL STATISTICS
INDO - INDONESIAN
INFO - INFORMATION SCIENCE
INTAG - INTERNAT AGRIC DEVEL
ITAL - ITALIAN
ITALA - ITALIAN LANGUAGE
ITALL - ITALIAN LITERATURE
JAPAN - JAPANESE
JPLIT - JAPANESE LITERATURE
JWST - JEWISH STUDIES
KHMER - KHMER
KOREA - KOREAN
KRLIT - KOREAN LITERATURE
LA - LANDSCAPE ARCHITECTURE
LANAR - LANDSCAPE ARCHITECTURE
LANG - LANGUAGES
LATA - LATIN AMERICAN STUDIES
LATIN - LATIN
LAW - LAW
LING - LINGUISTICS
LSP - LATINO STUDIES PROGRAM
MAE - MECH & AEROSPACE ENGIN
MATH - MATHEMATICS
MEDVL - MEDIEVAL STUDIES
MILS - MILITARY SCIENCE
MSE - MATERIALS SCIENCE & ENGIN
MUSIC - MUSIC
NAVS - NAVAL SCIENCE
NBA - JGSM MANAGEMENT ELECTIVE COURSES
NCC - JGSM COMMON CORE COURSES
NEH - NEH
NEPAL - NAPALI
NES - NEAR EASTERN STUDIES
NRE - JGSM NRE RESEARCH & ADVANCED STUDIES
NS - NUTRITIONAL SCIENCE
NSE - NUCLEAR SCIENCE & ENGINEERING
NTRES - NATURAL RESOURCES
ORIE - OPER RESEARCH & INDUSTRIAL ENGIN
PALI - PALI
PAM - POLICY ANALYSIS MANAGEMENT
PE - PHYSICAL EDUCATION
PED - PHYSICAL EDUCATION
PHIL - PHILOSOPHY
PHYS - PHYSICS
PLBR - PLANT BREEDING
PLPA - PLANT PATHOLOGY
PMA - PERFORMING AND MEDIA ARTS
POLSH - POLISH
PORT - PORTUGUESE
PSYCH - PSYCHOLOGY
QUECH - QUECHUA
RELST - RELIGIOUS STUDIES
ROMS - ROMANCE STUDIES
RUSSA - RUSSIAN LANGUAGE
RUSSL - RUSSIAN LITERATURE
SANSK - SANSKRIT
SCAS - SOIL, CROP AND ATMOSPHERIC SCIENCES
SEBCR - SERBO-CROATIAN
SHUM - SOCIETY FOR HUMANITIES
SINHA - SINHALESE
SNLIT - SANSKRIT LITERATURE
SOC - SOCIOLOGY
SPAN - SPANISH
SPANL - SPANISH LITERATURE
SPANR - SPANISH LANGUAGE - ROMANCE
STS - SCIENCE AND TECHNOLOGY STUDIES
STSCI - STATISTICAL SCIENCE
SWED - SWEDISH
SYSEN - SYSTEMS ENGINEERING
TAG - TAGALOG
TAM - THEORETICAL & APPL MECHANICS
TELL - TELLURIDE
THAI - THAI
THETR - THEATRE ARTS
TOX - TOXICOLOGY
TXA - TEXTILES AND APPAREL
URDU - URDU
VETA - ANATOMY
VETCS - CLINICAL SCIENCES
VETMI - MICROBIOLOGY
VETMM - VETERINARY MOLECULAR MEDICINE
VETPA - PATHOLOGY
VETPH - PHYSIOLOGY
VETPR - PHARMACOLOGY
VIEN - VITICULTURE & ENOLOGY
VIET - VIETNAMESE
VISST - VISUAL STUDIES
VTBMS - BIOMEDICAL SCIENCES
VTLIT - VIETNAMESE LITERATURE
VTMED - VET MEDICINE
VTPMD - POPULTION MEDICINE & DIAGNOSTI
WELSH - WELSH
WOMNS - WOMENS STUDIES
WRIT - WRITING PROGRAM
